//MAP CONVERTED BY dmm2tgm.py THIS HEADER COMMENT PREVENTS RECONVERSION, DO NOT REMOVE
"ag" = (
/turf/open/floor/iron/smooth_corner{
	dir = 8
	},
/area/space)
"az" = (
/turf/open/floor/iron/stairs/left,
/area/space)
"aH" = (
/obj/effect/turf_decal/siding/dark_green/inner_corner{
	dir = 1
	},
/turf/open/floor/iron,
/area/space)
"aN" = (
/obj/structure/reagent_dispensers/water_cooler,
/obj/effect/turf_decal/siding/wood{
	dir = 6
	},
/turf/open/floor/carpet/black,
/area/space)
"bb" = (
/obj/structure/railing{
	dir = 8
	},
/turf/open/misc/grass/planet,
/area/space)
"bm" = (
/obj/structure/sink/directional/south,
/obj/machinery/dryer{
	pixel_x = 24
	},
/obj/structure/mirror/directional/north{
	pixel_y = 32
	},
/turf/open/floor/iron,
/area/space)
"ci" = (
/obj/structure/fence/corner,
/turf/open/floor/asphalt/outdoors,
/area/space)
"cw" = (
/obj/structure/window/fulltile/colony_fabricator,
/obj/machinery/door/poddoor/shutters/colony_fabricator/preopen,
/turf/open/floor/plating,
/area/space)
"cB" = (
/obj/structure/chair/office,
/obj/effect/turf_decal/siding/dark_green/inner_corner{
	dir = 4
	},
/turf/open/floor/iron,
/area/space)
"cY" = (
/turf/open/floor/iron/smooth_large,
/area/space)
"dg" = (
/obj/structure/closet/crate/bin,
/turf/open/floor/iron,
/area/space)
"dK" = (
/obj/machinery/modular_computer/preset/civilian,
/obj/structure/window/reinforced/tinted/spawner/directional/west,
/obj/structure/window/reinforced/tinted/spawner/directional/north,
/turf/open/floor/iron,
/area/space)
"dT" = (
/obj/machinery/door/airlock/multi_tile/glass,
/obj/effect/turf_decal/siding/dark_green{
	dir = 8
	},
/turf/open/floor/iron,
/area/space)
"eb" = (
/obj/structure/closet/crate/bin,
/obj/effect/turf_decal/siding/dark_green{
	dir = 4
	},
/turf/open/floor/iron,
/area/space)
"ee" = (
/obj/structure/table,
/turf/open/floor/iron,
/area/space)
"ew" = (
/obj/structure/inflatable,
/turf/open/space/basic,
/area/space)
"eI" = (
/obj/effect/turf_decal/siding/dark_green/corner{
	dir = 1
	},
/turf/open/floor/iron,
/area/space)
"eO" = (
/obj/structure/chair/office,
/obj/effect/turf_decal/siding/dark_green{
	dir = 4
	},
/turf/open/floor/iron,
/area/space)
"fp" = (
/obj/structure/chair/sofa/bench/left{
	dir = 1
	},
/turf/open/misc/dirt/planet,
/area/space)
"fu" = (
/obj/structure/table,
/obj/structure/window/reinforced/tinted/spawner/directional/north,
/obj/structure/window/reinforced/tinted/spawner/directional/west,
/turf/open/floor/iron,
/area/space)
"fw" = (
/turf/open/floor/iron/dark/side,
/area/space)
"fG" = (
/obj/structure/railing{
	dir = 5
	},
/turf/open/misc/grass/planet,
/area/space)
"fM" = (
/obj/structure/table,
/obj/structure/closet/secure_closet/wall{
	pixel_y = 32
	},
/turf/open/floor/iron,
/area/space)
"fR" = (
/obj/structure/closet/secure_closet/freezer/fridge/open,
/turf/open/floor/iron,
/area/space)
"gs" = (
/obj/structure/window/reinforced/tinted/spawner/directional/east,
/obj/effect/turf_decal/siding/dark_green{
	dir = 1
	},
/turf/open/floor/iron,
/area/space)
"gv" = (
/obj/effect/turf_decal/siding/wideplating_new,
/turf/open/floor/carpet/blue,
/area/space)
"gQ" = (
/obj/structure/chair/comfy/shuttle{
	dir = 4
	},
/turf/open/floor/iron,
/area/space)
"ha" = (
/obj/structure/inflatable{
	color = "#556B2F";
	opacity = 1
	},
/turf/open/space/basic,
/area/space)
"hm" = (
/obj/machinery/modular_computer/preset/civilian{
	dir = 8
	},
/turf/open/floor/iron/smooth_large,
/area/space)
"hK" = (
/obj/machinery/door/airlock/multi_tile/glass{
	dir = 8
	},
/turf/open/floor/iron,
/area/space)
"hT" = (
/obj/structure/window/reinforced/tinted/spawner/directional/west,
/turf/open/floor/iron,
/area/space)
"ic" = (
/obj/structure/chair/office,
/obj/effect/turf_decal/siding/dark_green{
	dir = 8
	},
/turf/open/floor/iron,
/area/space)
"iT" = (
/obj/machinery/door/airlock/multi_tile/glass,
/turf/open/floor/iron/smooth_large,
/area/space)
"kk" = (
/obj/structure/chair/office{
	dir = 1
	},
/obj/structure/window/reinforced/tinted/spawner/directional/west,
/turf/open/floor/iron,
/area/space)
"kz" = (
/obj/structure/chair/sofa/bench/right{
	dir = 4
	},
/turf/open/misc/dirt/planet,
/area/space)
"kB" = (
/obj/structure/table,
/obj/structure/window/reinforced/tinted/spawner/directional/west,
/obj/structure/window/reinforced/tinted/spawner/directional/south,
/turf/open/floor/iron,
/area/space)
"kO" = (
/turf/open/misc/grass/planet,
/area/space)
"lg" = (
/obj/structure/curtain/cloth{
	color = "#556B2F"
	},
/turf/open/space/basic,
/area/space)
"lp" = (
/obj/structure/table,
/obj/machinery/door/poddoor/shutters/colony_fabricator/preopen,
/turf/open/floor/iron,
/area/space)
"mg" = (
/obj/effect/turf_decal/siding/yellow{
	dir = 4
	},
/turf/open/floor/asphalt/outdoors,
/area/space)
"mv" = (
/obj/structure/sink/directional/south,
/obj/structure/mirror/directional/north{
	pixel_y = 32
	},
/obj/machinery/dryer{
	pixel_x = -24
	},
/turf/open/floor/iron,
/area/space)
"mG" = (
/turf/open/floor/iron/smooth_half{
	dir = 1
	},
/area/space)
"mP" = (
/obj/structure/table,
/obj/structure/closet/secure_closet/wall{
	pixel_x = -32
	},
/turf/open/floor/iron,
/area/space)
"mS" = (
/obj/machinery/modular_computer/preset/civilian{
	dir = 1
	},
/obj/structure/window/reinforced/tinted/spawner/directional/south,
/obj/structure/window/reinforced/tinted/spawner/directional/east,
/obj/effect/turf_decal/siding/dark_green{
	dir = 4
	},
/turf/open/floor/iron,
/area/space)
"nt" = (
/obj/effect/turf_decal/siding/wideplating_new{
	dir = 6
	},
/turf/open/floor/carpet/blue,
/area/space)
"oX" = (
/obj/structure/flora/bush/flowers_br/style_random,
/turf/open/space/basic,
/area/space)
"pk" = (
/obj/structure/railing{
	dir = 6
	},
/turf/open/misc/grass/planet,
/area/space)
"px" = (
/obj/structure/fence/door,
/turf/open/floor/asphalt/outdoors,
/area/space)
"py" = (
/turf/open/space/basic,
/area/space)
"pP" = (
/obj/structure/chair/sofa/bench,
/turf/open/misc/dirt/planet,
/area/space)
"pU" = (
/obj/machinery/griddle/frontier_tabletop,
/obj/structure/table,
/turf/open/floor/iron,
/area/space)
"qt" = (
/obj/effect/turf_decal/siding/dark_green{
	dir = 4
	},
/turf/open/floor/iron,
/area/space)
"qK" = (
/obj/structure/closet/crate/bin,
/turf/open/floor/iron/smooth_large,
/area/space)
"rf" = (
/turf/open/floor/iron,
/area/space)
"ri" = (
/obj/structure/chair/sofa/bench{
	dir = 4
	},
/turf/open/misc/dirt/planet,
/area/space)
"rv" = (
/obj/structure/table,
/turf/open/misc/dirt/planet,
/area/space)
"rA" = (
/obj/machinery/power/shuttle_engine/propulsion{
	dir = 1
	},
/turf/open/misc/grass/planet,
/area/space)
"rO" = (
/obj/machinery/modular_computer/preset/civilian{
	dir = 1
	},
/obj/structure/window/reinforced/tinted/spawner/directional/west,
/obj/structure/window/reinforced/tinted/spawner/directional/south,
/turf/open/floor/iron,
/area/space)
"sm" = (
/obj/structure/fence{
	dir = 1
	},
/turf/open/floor/asphalt/outdoors,
/area/space)
"sD" = (
/turf/open/floor/iron/smooth_corner{
	dir = 4
	},
/area/space)
"sK" = (
/obj/structure/closet/crate/bin,
/turf/open/misc/dirt/planet,
/area/space)
"tf" = (
/obj/effect/turf_decal/siding/wood{
	dir = 9
	},
/turf/open/floor/carpet/black,
/area/space)
"tm" = (
/obj/structure/table/wood,
/turf/open/floor/carpet/black,
/area/space)
"tO" = (
/turf/closed/wall/prefab_plastic,
/area/space)
"uw" = (
/obj/effect/turf_decal/siding/dark_green,
/turf/open/floor/iron,
/area/space)
"uB" = (
/obj/structure/railing{
	dir = 9
	},
/turf/open/misc/grass/planet,
/area/space)
"uC" = (
/obj/machinery/door/airlock/colony_prefab,
/turf/open/space/basic,
/area/space)
"vc" = (
/obj/structure/window/reinforced/tinted/spawner/directional/east,
/turf/open/floor/iron,
/area/space)
"vQ" = (
/obj/structure/window/reinforced/tinted/spawner/directional/west,
/obj/structure/window/reinforced/tinted/spawner/directional/south,
/obj/machinery/modular_computer/preset/civilian{
	dir = 1
	},
/obj/effect/turf_decal/siding/dark_green{
	dir = 8
	},
/turf/open/floor/iron,
/area/space)
"vV" = (
/turf/open/misc/dirt/planet,
/area/space)
"wv" = (
/obj/structure/chair/sofa/bench/left,
/turf/open/misc/dirt/planet,
/area/space)
"wy" = (
/obj/machinery/modular_computer/preset/civilian,
/obj/structure/window/reinforced/tinted/spawner/directional/east,
/obj/structure/window/reinforced/tinted/spawner/directional/north,
/obj/effect/turf_decal/siding/dark_green{
	dir = 4
	},
/turf/open/floor/iron,
/area/space)
"wP" = (
/obj/machinery/modular_computer/preset/civilian{
	dir = 8
	},
/turf/open/floor/iron,
/area/space)
"xD" = (
/obj/structure/chair/plastic{
	dir = 1
	},
/turf/open/floor/iron,
/area/space)
"yH" = (
/obj/effect/turf_decal/siding/dark_green{
	dir = 1
	},
/turf/open/floor/iron,
/area/space)
"yQ" = (
/obj/structure/table,
/obj/machinery/coffeemaker/impressa,
/obj/item/storage/box/coffeepack/robusta{
	pixel_x = 10
	},
/turf/open/floor/iron,
/area/space)
"yX" = (
/obj/structure/flora/bush/ferny/style_random,
/turf/open/space/basic,
/area/space)
"za" = (
/obj/machinery/door/poddoor/shutters/colony_fabricator/preopen,
/obj/effect/turf_decal/loading_area/white{
	dir = 8
	},
/turf/open/floor/iron,
/area/space)
"zf" = (
/obj/structure/table/wood,
/obj/item/storage/fancy/coffee_condi_display,
/obj/effect/turf_decal/siding/wood{
	dir = 5
	},
/turf/open/floor/carpet/black,
/area/space)
"zh" = (
/obj/structure/table,
/obj/effect/turf_decal/siding/dark_green/inner_corner{
	dir = 1
	},
/obj/machinery/coffeemaker/impressa,
/turf/open/floor/iron,
/area/space)
"zn" = (
/turf/open/floor/iron/smooth_half,
/area/space)
"zN" = (
/turf/open/floor/iron/stairs/right{
	dir = 4
	},
/area/space)
"zU" = (
/turf/closed/wall/r_wall,
/area/space)
"Ac" = (
/obj/structure/flora/tree/jungle/style_random,
/turf/open/space/basic,
/area/space)
"AB" = (
/obj/structure/table/wood,
/obj/machinery/coffeemaker,
/obj/effect/turf_decal/siding/wood{
	dir = 6
	},
/turf/open/floor/carpet/black,
/area/space)
"AV" = (
/obj/structure/table,
/turf/open/floor/iron/smooth_large,
/area/space)
"BH" = (
/obj/structure/railing,
/turf/open/misc/grass/planet,
/area/space)
"BZ" = (
/turf/open/floor/iron/smooth_corner,
/area/space)
"Cc" = (
/turf/open/floor/plating,
/area/space)
"Cp" = (
/obj/structure/fence/corner{
	dir = 1
	},
/turf/open/floor/asphalt/outdoors,
/area/space)
"Cq" = (
/obj/structure/window/reinforced/tinted/spawner/directional/south,
/obj/structure/window/reinforced/tinted/spawner/directional/east,
/obj/structure/table,
/turf/open/floor/iron,
/area/space)
"CA" = (
/obj/effect/turf_decal/siding/dark_green/corner,
/turf/open/floor/iron,
/area/space)
"CP" = (
/obj/structure/table,
/obj/structure/window/reinforced/tinted/spawner/directional/north,
/obj/structure/window/reinforced/tinted/spawner/directional/east,
/turf/open/floor/iron,
/area/space)
"Dg" = (
/turf/open/floor/iron/stairs/right,
/area/space)
"EG" = (
/obj/structure/flora/tree/jungle/small/style_random,
/turf/open/space/basic,
/area/space)
"ES" = (
/obj/structure/table,
/obj/structure/window/reinforced/tinted/spawner/directional/west,
/turf/open/floor/iron,
/area/space)
"Fe" = (
/obj/structure/chair/sofa/bench/right{
	dir = 1
	},
/turf/open/misc/dirt/planet,
/area/space)
"Fo" = (
/obj/structure/chair/sofa/bench/right,
/turf/open/misc/dirt/planet,
/area/space)
"FJ" = (
/turf/open/floor/iron/dark,
/area/space)
"FK" = (
/obj/structure/fence{
	dir = 4
	},
/turf/open/floor/asphalt/outdoors,
/area/space)
"FV" = (
/obj/structure/table,
/obj/item/plate/large,
/obj/item/food/croissant,
/obj/item/food/croissant,
/obj/item/food/croissant,
/obj/item/food/croissant,
/turf/open/floor/iron,
/area/space)
"Gj" = (
/obj/structure/chair/plastic{
	dir = 1
	},
/obj/effect/turf_decal/siding/wideplating_new,
/turf/open/floor/carpet/blue,
/area/space)
"Gn" = (
/obj/structure/railing{
	dir = 10
	},
/turf/open/misc/grass/planet,
/area/space)
"Gq" = (
/obj/structure/toilet{
	dir = 8
	},
/turf/open/floor/iron,
/area/space)
"Gv" = (
/obj/structure/table,
/obj/structure/window/reinforced/tinted/spawner/directional/south,
/obj/structure/window/reinforced/tinted/spawner/directional/east,
/turf/open/floor/iron,
/area/space)
"Gw" = (
/obj/structure/chair/sofa/bench/right{
	dir = 8
	},
/turf/open/misc/dirt/planet,
/area/space)
"Hc" = (
/obj/structure/chair/plastic{
	dir = 4
	},
/turf/open/floor/carpet/blue,
/area/space)
"Hf" = (
/obj/structure/fence,
/turf/open/floor/asphalt/outdoors,
/area/space)
"Hl" = (
/obj/structure/chair/office{
	dir = 4
	},
/turf/open/floor/iron/smooth_large,
/area/space)
"Ht" = (
/obj/structure/chair/sofa/corp{
	dir = 1
	},
/obj/effect/turf_decal/siding/wood,
/turf/open/floor/carpet/black,
/area/space)
"Hv" = (
/obj/structure/railing{
	dir = 4
	},
/turf/open/misc/grass/planet,
/area/space)
"HV" = (
/obj/structure/toilet{
	dir = 4
	},
/turf/open/floor/iron,
/area/space)
"Ir" = (
/obj/structure/window/fulltile/colony_fabricator,
/turf/open/space/basic,
/area/space)
"Iu" = (
/obj/machinery/door/airlock/colony_prefab,
/turf/open/floor/iron,
/area/space)
"IQ" = (
/obj/structure/closet/crate/bin,
/obj/effect/turf_decal/siding/dark_green/inner_corner{
	dir = 1
	},
/turf/open/floor/iron,
/area/space)
"IZ" = (
/obj/effect/turf_decal/siding/dark_green/corner{
	dir = 8
	},
/turf/open/floor/iron,
/area/space)
"Jj" = (
/obj/structure/table,
/turf/open/floor/iron/smooth_half{
	dir = 1
	},
/area/space)
"Jl" = (
/obj/structure/table,
/obj/effect/turf_decal/siding/dark_green/corner{
	dir = 1
	},
/obj/item/storage/box/coffeepack/robusta{
	pixel_x = -16
	},
/obj/structure/closet/mini_fridge,
/turf/open/floor/iron,
/area/space)
"Jt" = (
/obj/machinery/modular_computer/preset/civilian{
	dir = 4
	},
/turf/open/floor/iron/smooth_corner{
	dir = 4
	},
/area/space)
"JE" = (
/obj/structure/table/wood,
/obj/effect/turf_decal/siding/wood{
	dir = 8
	},
/turf/open/floor/carpet/black,
/area/space)
"Kn" = (
/obj/structure/chair/office{
	dir = 1
	},
/obj/effect/turf_decal/siding/dark_green/inner_corner,
/turf/open/floor/iron,
/area/space)
"Lb" = (
/obj/structure/chair/office{
	dir = 4
	},
/turf/open/floor/iron/smooth_half,
/area/space)
"Lu" = (
/obj/structure/chair/office{
	dir = 8
	},
/turf/open/floor/iron/smooth_large,
/area/space)
"LE" = (
/obj/structure/chair/office{
	dir = 1
	},
/obj/effect/turf_decal/siding/dark_green{
	dir = 4
	},
/turf/open/floor/iron,
/area/space)
"LS" = (
/obj/machinery/door/airlock/multi_tile/glass,
/turf/open/floor/iron,
/area/space)
"Me" = (
/turf/open/water/jungle,
/area/space)
"MD" = (
/obj/machinery/modular_computer/preset/civilian{
	dir = 1
	},
/obj/effect/turf_decal/siding/dark_green{
	dir = 4
	},
/turf/open/floor/iron,
/area/space)
"MQ" = (
/obj/structure/chair/sofa/bench/left{
	dir = 8
	},
/turf/open/misc/dirt/planet,
/area/space)
"Nj" = (
/turf/open/floor/asphalt/outdoors,
/area/space)
"Oo" = (
/obj/effect/turf_decal/siding/wood{
	dir = 1
	},
/turf/open/floor/carpet/black,
/area/space)
"OE" = (
/turf/closed/wall,
/area/space)
"OW" = (
/obj/machinery/power/shuttle_engine/propulsion,
/turf/open/misc/grass/planet,
/area/space)
"OY" = (
/turf/open/floor/iron/white,
/area/space)
"Pm" = (
/obj/structure/chair/office,
/obj/effect/turf_decal/siding/dark_green{
	dir = 1
	},
/turf/open/floor/iron,
/area/space)
"Ps" = (
/obj/structure/fence{
	dir = 4
	},
/turf/open/misc/grass/planet,
/area/space)
"Qn" = (
/obj/effect/turf_decal/siding/dark_green{
	dir = 8
	},
/turf/open/floor/iron,
/area/space)
"QT" = (
/obj/machinery/modular_computer/preset/civilian{
	dir = 4
	},
/turf/open/floor/iron/smooth_large,
/area/space)
"QX" = (
/obj/structure/chair/office{
	dir = 8
	},
/turf/open/floor/iron/smooth_half,
/area/space)
"QZ" = (
/obj/structure/chair/office,
/obj/structure/window/reinforced/tinted/spawner/directional/west,
/turf/open/floor/iron,
/area/space)
"RB" = (
/obj/structure/closet/crate/bin,
/turf/open/floor/iron/smooth_half,
/area/space)
"RE" = (
/obj/effect/turf_decal/siding/wideplating_new{
	dir = 1
	},
/turf/open/floor/carpet/blue,
/area/space)
"RH" = (
/obj/effect/turf_decal/siding/wideplating_new{
	dir = 5
	},
/turf/open/floor/carpet/blue,
/area/space)
"RP" = (
/obj/effect/turf_decal/siding/wood/corner,
/turf/open/floor/carpet/black,
/area/space)
"Se" = (
/obj/structure/closet/crate/bin,
/obj/effect/turf_decal/siding/wood{
	dir = 6
	},
/turf/open/floor/carpet/black,
/area/space)
"So" = (
/obj/effect/turf_decal/siding/dark_green/inner_corner{
	dir = 8
	},
/turf/open/floor/iron,
/area/space)
"SM" = (
/obj/machinery/modular_computer/preset/civilian{
	dir = 8
	},
/turf/open/floor/iron/smooth_half,
/area/space)
"TL" = (
/obj/structure/chair/sofa/corp/left{
	dir = 1
	},
/obj/effect/turf_decal/siding/wood{
	dir = 10
	},
/turf/open/floor/carpet/black,
/area/space)
"TM" = (
/obj/structure/chair/plastic{
	dir = 8
	},
/obj/effect/turf_decal/siding/wideplating_new{
	dir = 4
	},
/turf/open/floor/carpet/blue,
/area/space)
"TO" = (
/obj/structure/chair/sofa/bench/left{
	dir = 4
	},
/turf/open/misc/dirt/planet,
/area/space)
"Uc" = (
/turf/closed/indestructible/rock,
/area/space)
"Ux" = (
/turf/open/floor/iron/stairs/left{
	dir = 4
	},
/area/space)
"UY" = (
/obj/structure/railing{
	dir = 1
	},
/turf/open/misc/grass/planet,
/area/space)
"Vd" = (
/turf/open/floor/iron/stairs/left{
	dir = 8
	},
/area/space)
"Vr" = (
/turf/open/floor/iron/stairs/right{
	dir = 8
	},
/area/space)
"Wa" = (
/obj/structure/chair/sofa/corp/right{
	dir = 1
	},
/obj/effect/turf_decal/siding/wood{
	dir = 6
	},
/turf/open/floor/carpet/black,
/area/space)
"Wb" = (
/obj/effect/turf_decal/siding/yellow{
	dir = 8
	},
/turf/open/floor/asphalt/outdoors,
/area/space)
"WP" = (
/obj/structure/chair/office{
	dir = 1
	},
/obj/effect/turf_decal/siding/dark_green,
/turf/open/floor/iron,
/area/space)
"Xb" = (
/obj/structure/window/fulltile/colony_fabricator,
/turf/open/floor/plating,
/area/space)
"Xi" = (
/obj/structure/window/reinforced/tinted/spawner/directional/east,
/obj/effect/turf_decal/siding/dark_green,
/turf/open/floor/iron,
/area/space)
"XE" = (
/obj/effect/turf_decal/siding/wood/corner{
	dir = 1
	},
/turf/open/floor/carpet/black,
/area/space)
"XL" = (
/obj/structure/chair/plastic,
/obj/effect/turf_decal/siding/wideplating_new{
	dir = 1
	},
/turf/open/floor/carpet/blue,
/area/space)
"XO" = (
/obj/structure/table,
/obj/effect/turf_decal/siding/dark_green/inner_corner{
	dir = 1
	},
/obj/machinery/microwave,
/turf/open/floor/iron,
/area/space)
"Ym" = (
/obj/structure/table,
/obj/item/reagent_containers/condiment/ketchup{
	pixel_x = 8;
	pixel_y = 12
	},
/obj/item/reagent_containers/condiment/mayonnaise{
	pixel_y = 12;
	pixel_x = -2
	},
/turf/open/floor/iron,
/area/space)
"Yv" = (
/obj/effect/turf_decal/siding/dark_green/inner_corner,
/turf/open/floor/iron,
/area/space)
"YD" = (
/obj/structure/chair/sofa/bench{
	dir = 8
	},
/turf/open/misc/dirt/planet,
/area/space)
"YF" = (
/obj/structure/billboard{
	pixel_x = -12
	},
/turf/open/floor/iron,
/area/space)
"YS" = (
/obj/structure/table,
/turf/open/floor/carpet/blue,
/area/space)

(1,1,1) = {"
kO
kO
kO
kO
kO
kO
kO
kO
kO
kO
kO
kO
kO
kO
Nj
Nj
kO
Ps
kO
kO
kO
kO
kO
kO
kO
kO
kO
kO
kO
kO
kO
kO
kO
kO
kO
kO
kO
kO
kO
kO
kO
kO
Ps
Nj
Nj
Nj
Nj
Nj
Nj
Nj
Nj
Nj
Nj
Nj
Nj
Nj
Nj
Nj
FK
kO
kO
kO
kO
kO
kO
kO
kO
kO
kO
kO
"}
(2,1,1) = {"
kO
kO
kO
kO
kO
kO
TO
ri
kz
kO
kO
kO
kO
kO
Nj
Nj
kO
Ps
kO
kO
kO
kO
kO
kO
kO
kO
kO
kO
kO
kO
kO
vV
sK
vV
vV
vV
vV
sK
vV
kO
kO
kO
Ps
Nj
Nj
Nj
Nj
Nj
Nj
Nj
Nj
Nj
Nj
Nj
Nj
Nj
Nj
Nj
FK
kO
kO
kO
kO
kO
kO
kO
kO
kO
kO
kO
"}
(3,1,1) = {"
kO
kO
kO
kO
kO
vV
vV
vV
vV
sK
kO
kO
kO
kO
Nj
Nj
kO
Ps
kO
kO
kO
kO
kO
kO
kO
kO
kO
kO
kO
kO
kO
Fo
rv
fp
Nj
Nj
Fo
rv
fp
kO
kO
kO
Ps
Nj
Nj
Nj
Nj
Nj
Nj
Nj
Nj
Nj
Nj
vV
vV
vV
vV
vV
FK
kO
kO
kO
kO
kO
kO
kO
kO
kO
kO
kO
"}
(4,1,1) = {"
kO
kO
kO
Nj
Nj
Nj
Nj
Nj
Nj
Nj
Nj
Nj
Nj
Nj
Nj
Nj
kO
Ps
kO
kO
kO
kO
kO
kO
kO
kO
kO
kO
kO
kO
kO
wv
rv
Fe
Nj
Nj
wv
rv
Fe
kO
kO
kO
Ps
vV
vV
vV
vV
vV
Nj
Nj
Nj
Nj
Nj
Nj
Nj
Nj
Nj
Nj
FK
kO
kO
kO
kO
kO
kO
kO
kO
kO
kO
kO
"}
(5,1,1) = {"
kO
kO
kO
Nj
Nj
Nj
Nj
Nj
Nj
Nj
Nj
Nj
Nj
Nj
Nj
Nj
kO
Ps
kO
kO
kO
kO
kO
kO
kO
kO
kO
kO
kO
kO
kO
vV
vV
vV
Nj
Nj
vV
vV
vV
kO
kO
kO
Ps
Nj
Nj
Nj
Nj
Nj
Nj
Nj
Nj
Nj
Nj
Nj
Nj
Nj
Nj
Nj
FK
kO
kO
kO
kO
kO
kO
kO
kO
kO
kO
kO
"}
(6,1,1) = {"
kO
kO
kO
Nj
Nj
kO
kO
kO
kO
kO
kO
kO
kO
kO
Nj
Nj
kO
Ps
kO
kO
kO
kO
kO
kO
kO
kO
kO
kO
kO
kO
kO
vV
sK
vV
Nj
Nj
vV
sK
vV
kO
kO
kO
Ps
Nj
Nj
Nj
Nj
Nj
Nj
Nj
Nj
Nj
Nj
Nj
Nj
Nj
Nj
Nj
FK
kO
kO
kO
kO
kO
kO
kO
kO
kO
kO
kO
"}
(7,1,1) = {"
kO
kO
kO
Nj
Nj
kO
kO
kO
kO
kO
kO
kO
kO
kO
Vd
Vr
kO
Ps
kO
kO
kO
kO
kO
kO
kO
kO
kO
kO
kO
kO
kO
Fo
rv
fp
Nj
Nj
Fo
rv
fp
kO
kO
kO
Ps
Nj
Nj
Nj
Nj
Nj
Nj
Nj
Nj
Nj
Nj
vV
vV
vV
vV
vV
FK
kO
kO
kO
kO
kO
kO
kO
kO
kO
kO
kO
"}
(8,1,1) = {"
kO
kO
kO
Nj
Nj
kO
kO
kO
kO
kO
Xb
Xb
Xb
tO
rf
hK
tO
tO
Xb
Xb
Xb
Xb
Xb
Xb
kO
kO
kO
kO
tO
tO
tO
wv
rv
Fe
Nj
Nj
wv
rv
Fe
kO
kO
kO
Ps
vV
vV
vV
vV
vV
Nj
Nj
Nj
Nj
Nj
Nj
Nj
Nj
Nj
Nj
FK
kO
kO
kO
kO
kO
kO
kO
kO
kO
kO
kO
"}
(9,1,1) = {"
kO
kO
sK
Nj
Nj
kO
kO
kO
kO
Xb
Xb
aH
ic
vQ
Qn
Qn
So
tO
BZ
mG
mG
mG
sD
Xb
Xb
kO
kO
kO
tO
HV
tO
Nj
Nj
Nj
Nj
Nj
Nj
Nj
Nj
kO
kO
kO
Ps
Nj
Nj
Nj
Nj
Nj
Nj
Nj
Nj
Nj
Nj
Nj
Nj
Nj
Nj
Nj
FK
kO
kO
kO
kO
kO
kO
kO
kO
kO
kO
kO
"}
(10,1,1) = {"
kO
Fo
vV
Nj
Nj
kO
kO
kO
Xb
Xb
zh
eI
vc
Cq
rf
rf
IZ
dT
So
cY
cY
cY
zn
cY
Xb
Xb
kO
kO
tO
uC
tO
Nj
Nj
Nj
Nj
Nj
Nj
Nj
Nj
kO
kO
kO
Ps
Nj
Nj
Nj
Nj
Nj
Nj
Nj
Nj
Nj
Nj
Nj
Nj
Nj
Nj
Nj
FK
kO
kO
kO
kO
kO
kO
kO
kO
kO
kO
kO
"}
(11,1,1) = {"
kO
pP
vV
Nj
Nj
kO
kO
Xb
Xb
XO
Jl
rf
rf
dg
rf
rf
CA
qt
Yv
cY
cY
cY
zn
cY
qK
Xb
Xb
kO
tO
bm
rf
Nj
Nj
uB
bb
bb
Gn
Nj
Nj
kO
kO
kO
Ps
Nj
Nj
Nj
Nj
Nj
Nj
Nj
Nj
Nj
Nj
vV
vV
vV
vV
vV
FK
kO
kO
kO
kO
kO
kO
kO
kO
kO
kO
kO
"}
(12,1,1) = {"
kO
wv
vV
Nj
Nj
kO
kO
Xb
IQ
eI
rf
rf
rf
rf
rf
rf
uw
tO
RB
cY
cY
cY
ag
mG
Jj
Jt
Xb
kO
tO
tO
tO
Nj
Nj
UY
Me
Me
BH
Nj
Nj
kO
kO
kO
Ps
vV
vV
vV
vV
vV
Nj
Nj
Nj
Nj
Nj
Nj
Nj
Nj
Nj
Nj
FK
kO
kO
kO
kO
kO
kO
kO
kO
kO
kO
kO
"}
(13,1,1) = {"
kO
kO
vV
Nj
Nj
kO
kO
Xb
yH
rf
rf
rf
rf
rf
rf
rf
uw
tO
zn
cY
cY
cY
cY
cY
cY
QX
Xb
kO
tO
mv
rf
Nj
Nj
UY
Me
Me
BH
Nj
Nj
kO
kO
kO
Ps
Nj
Nj
Nj
Nj
Nj
Nj
Nj
Nj
Nj
Nj
Nj
Nj
Nj
Nj
Nj
FK
kO
kO
kO
kO
kO
kO
kO
kO
kO
kO
kO
"}
(14,1,1) = {"
kO
kO
kO
Nj
Nj
kO
kO
tO
Pm
rO
dK
kk
rf
QZ
rO
dK
WP
tO
zn
cY
cY
cY
cY
cY
cY
Lb
Xb
kO
tO
Iu
tO
Nj
Nj
UY
Me
Me
BH
Nj
Nj
kO
kO
kO
Ps
Nj
Nj
Nj
Nj
Nj
Nj
Nj
Nj
Nj
Nj
Nj
Nj
Nj
Nj
Nj
FK
kO
kO
kO
kO
kO
kO
kO
kO
kO
kO
kO
"}
(15,1,1) = {"
kO
kO
kO
Nj
Nj
kO
kO
tO
gs
Gv
CP
vc
rf
vc
Gv
CP
Xi
tO
zn
AV
QT
AV
cY
cY
AV
SM
Xb
kO
tO
Gq
tO
Nj
Nj
UY
Me
Me
BH
Nj
Nj
kO
kO
kO
Ps
Nj
Nj
Nj
Nj
Nj
Nj
Nj
Nj
Nj
Nj
vV
vV
vV
vV
vV
FK
kO
kO
kO
kO
kO
kO
kO
kO
kO
kO
kO
"}
(16,1,1) = {"
kO
kO
kO
Nj
Nj
kO
kO
tO
yH
rf
rf
rf
rf
rf
rf
rf
uw
tO
zn
cY
Lu
AV
cY
cY
cY
zn
tO
kO
tO
tO
tO
Nj
Nj
fG
Hv
Hv
pk
Nj
Nj
kO
kO
kO
Ps
vV
vV
vV
vV
vV
Nj
Nj
Nj
Nj
Nj
Nj
Nj
Nj
Nj
Nj
FK
kO
kO
kO
kO
kO
kO
kO
kO
kO
kO
kO
"}
(17,1,1) = {"
kO
kO
kO
Nj
Nj
kO
kO
tO
yH
kB
fu
hT
rf
hT
ES
fu
uw
tO
RB
cY
cY
AV
cY
cY
cY
cY
iT
az
Nj
Nj
Nj
Nj
Nj
Nj
Nj
Nj
Nj
Nj
Nj
Nj
Nj
Nj
px
Nj
Nj
Nj
Nj
Nj
Nj
Nj
Nj
Nj
Nj
Nj
Nj
Nj
Nj
Nj
FK
kO
kO
kO
kO
kO
kO
kO
kO
kO
kO
kO
"}
(18,1,1) = {"
Nj
Nj
Nj
Nj
Nj
kO
kO
tO
cB
mS
wy
LE
eb
eO
MD
wy
Kn
tO
zn
cY
cY
AV
cY
cY
cY
cY
cY
Dg
Nj
Nj
Nj
Nj
Nj
Nj
Nj
Nj
Nj
Nj
Nj
Nj
Nj
Nj
px
Nj
Nj
Nj
Nj
Nj
Nj
Nj
Nj
Nj
Nj
Nj
Nj
Nj
Nj
Nj
FK
Nj
Nj
Nj
Nj
Nj
Nj
Nj
Nj
Nj
Nj
Nj
"}
(19,1,1) = {"
Nj
Nj
Nj
Nj
Nj
kO
kO
tO
tO
tO
tO
tO
tO
tO
tO
tO
tO
tO
zn
cY
Hl
AV
cY
cY
cY
cY
tO
kO
kO
kO
kO
kO
kO
kO
kO
kO
sK
vV
vV
vV
sK
kO
Ps
vV
vV
vV
vV
vV
Nj
Nj
Nj
Nj
Nj
vV
vV
vV
vV
vV
FK
Nj
Nj
Nj
Nj
Nj
Nj
Nj
Nj
Nj
Nj
Nj
"}
(20,1,1) = {"
kO
kO
kO
Nj
Nj
kO
kO
tO
dg
rf
RE
Hc
Hc
Hc
Hc
gv
rf
Xb
zn
AV
hm
AV
cY
cY
cY
cY
Xb
kO
kO
kO
kO
kO
kO
kO
kO
rA
tO
za
za
za
tO
OW
Ps
Nj
Nj
Nj
Nj
Nj
Nj
Nj
Nj
Nj
Nj
Nj
Nj
Nj
Nj
Nj
FK
Nj
Nj
tO
tO
tO
tO
tO
tO
tO
Nj
Nj
"}
(21,1,1) = {"
kO
kO
kO
Nj
Nj
kO
kO
tO
YF
rf
RE
YS
YS
YS
YS
Gj
rf
Xb
zn
cY
cY
cY
cY
tf
JE
TL
Xb
kO
kO
kO
kO
kO
kO
kO
kO
kO
cw
ee
xD
rf
tO
kO
Ps
Nj
Nj
Nj
Nj
Nj
Nj
Nj
Nj
Nj
Nj
Nj
Nj
Nj
Nj
Nj
FK
Nj
Nj
tO
rf
rf
rf
rf
rf
tO
Nj
Nj
"}
(22,1,1) = {"
kO
kO
kO
Nj
Nj
kO
kO
tO
rf
rf
XL
YS
YS
YS
YS
gv
rf
Xb
zn
cY
cY
cY
cY
Oo
tm
Ht
Xb
kO
kO
kO
kO
kO
kO
kO
kO
kO
cw
Ym
xD
rf
tO
kO
Ps
Nj
Nj
Nj
Nj
Nj
Nj
Nj
Nj
Nj
Nj
Nj
Nj
Nj
Nj
Nj
FK
Nj
Nj
tO
rf
rf
rf
rf
rf
tO
Nj
Nj
"}
(23,1,1) = {"
kO
kO
kO
Nj
Nj
kO
kO
tO
rf
rf
RE
YS
YS
YS
YS
Gj
rf
tO
zn
cY
cY
cY
tf
XE
RP
Wa
Xb
kO
kO
kO
kO
kO
kO
kO
kO
kO
cw
ee
rf
rf
tO
kO
Ps
vV
vV
vV
vV
vV
Nj
Nj
Nj
Nj
Nj
vV
vV
vV
vV
vV
FK
Nj
Nj
Iu
rf
rf
rf
rf
rf
tO
Nj
Nj
"}
(24,1,1) = {"
kO
kO
sK
Nj
Nj
kO
kO
tO
tO
rf
RH
TM
TM
TM
TM
nt
rf
LS
cY
cY
cY
tf
XE
RP
Se
Xb
Xb
kO
kO
py
py
py
py
py
kO
kO
cw
ee
ee
rf
tO
kO
Ps
Nj
Nj
Nj
Nj
Nj
Nj
Nj
Nj
Nj
Nj
Nj
Nj
Nj
Nj
Nj
px
Nj
Nj
tO
rf
rf
rf
rf
rf
tO
Nj
Nj
"}
(25,1,1) = {"
kO
Fo
vV
Nj
Nj
kO
kO
kO
tO
tO
rf
rf
rf
rf
rf
rf
rf
rf
cY
cY
cY
Oo
RP
aN
Xb
Xb
kO
kO
kO
py
vV
rf
cY
py
kO
kO
tO
fM
rf
rf
tO
kO
Ps
Nj
Nj
Nj
Nj
Nj
Nj
Nj
Nj
Nj
Nj
Nj
Nj
Nj
Nj
Nj
ci
Hf
Hf
tO
cw
lp
lp
cw
cw
tO
sm
sm
"}
(26,1,1) = {"
kO
pP
vV
Nj
Nj
kO
kO
kO
kO
tO
tO
yQ
FV
dg
rf
rf
rf
tO
ag
mG
cY
zf
AB
Xb
Xb
kO
kO
kO
kO
py
kO
FJ
BZ
py
kO
kO
tO
pU
ee
fR
tO
kO
Ps
Nj
Nj
Nj
Nj
Nj
Nj
Nj
Nj
Nj
Nj
Nj
Nj
Nj
Nj
Nj
Nj
Nj
Nj
Nj
Nj
Nj
Nj
Nj
Nj
Nj
Nj
Nj
"}
(27,1,1) = {"
kO
wv
vV
Nj
Nj
kO
kO
kO
kO
kO
tO
tO
tO
tO
rf
hK
tO
tO
Xb
Xb
Xb
Xb
Xb
Xb
kO
kO
kO
kO
kO
yX
Me
fw
zn
py
kO
kO
tO
tO
tO
tO
tO
kO
Ps
vV
vV
vV
vV
vV
Nj
Nj
Nj
Nj
Nj
Nj
Nj
Nj
Nj
Nj
Nj
Nj
Nj
Nj
Nj
Nj
Nj
Nj
Nj
Nj
Nj
Nj
"}
(28,1,1) = {"
kO
kO
vV
Nj
Nj
kO
kO
kO
kO
kO
kO
kO
kO
kO
zN
Ux
kO
Ps
kO
kO
kO
kO
kO
kO
kO
kO
kO
kO
kO
oX
Nj
Cc
OY
py
kO
kO
Iu
gQ
mP
gQ
Iu
kO
Ps
Nj
Nj
Nj
Nj
Nj
Nj
Nj
Nj
Nj
Nj
Nj
Nj
Nj
Nj
Nj
Nj
mg
mg
Nj
mg
mg
Nj
mg
mg
Nj
mg
mg
"}
(29,1,1) = {"
kO
kO
kO
Nj
Nj
kO
kO
kO
kO
kO
kO
kO
kO
kO
Nj
Nj
kO
Ps
kO
kO
kO
kO
kO
kO
kO
kO
kO
kO
kO
EG
py
zU
Uc
py
kO
kO
tO
wP
ee
wP
tO
kO
Ps
Nj
Nj
Nj
Nj
Nj
Nj
Nj
Nj
Nj
Nj
Nj
Nj
Nj
Nj
Nj
Nj
Wb
Wb
Nj
Wb
Wb
Nj
Wb
Wb
Nj
Wb
Wb
"}
(30,1,1) = {"
kO
kO
kO
Nj
Nj
Nj
Nj
Nj
Nj
Nj
Nj
Nj
Nj
Nj
Nj
Nj
kO
Ps
kO
kO
kO
kO
kO
kO
kO
kO
kO
kO
kO
py
py
OE
Dg
py
kO
rA
tO
Xb
Xb
Xb
tO
OW
Ps
Nj
Nj
Nj
Nj
Nj
Nj
Nj
Nj
Nj
Nj
Nj
Nj
Nj
Nj
Nj
Nj
Nj
Nj
Nj
Nj
Nj
Nj
Nj
Nj
Nj
Nj
Nj
"}
(31,1,1) = {"
kO
kO
kO
Nj
Nj
Nj
Nj
Nj
Nj
Nj
Nj
Nj
Nj
Nj
Nj
Nj
kO
Ps
kO
kO
kO
kO
kO
kO
kO
kO
kO
kO
kO
Ac
Ir
tO
lg
py
kO
kO
kO
kO
kO
kO
kO
kO
Ps
vV
vV
vV
vV
vV
Nj
Nj
Nj
Nj
Nj
Nj
Nj
Nj
Nj
Nj
Nj
Nj
Nj
Nj
Nj
Nj
Nj
Nj
Nj
Nj
Nj
Nj
"}
(32,1,1) = {"
kO
kO
kO
kO
kO
sK
vV
vV
vV
vV
kO
kO
kO
kO
Nj
Nj
kO
Ps
kO
kO
kO
kO
kO
kO
kO
kO
kO
kO
kO
py
py
ha
ew
py
kO
kO
kO
kO
kO
kO
kO
kO
Ps
Nj
Nj
Nj
Nj
Nj
Nj
Nj
Nj
Nj
Nj
Nj
Nj
Nj
Nj
Nj
Cp
Hf
Hf
Hf
Hf
Hf
Hf
Hf
Hf
Hf
Hf
Hf
"}
(33,1,1) = {"
kO
kO
kO
kO
kO
kO
Gw
YD
MQ
kO
kO
kO
kO
kO
Nj
Nj
kO
Ps
kO
kO
kO
kO
kO
kO
kO
kO
kO
kO
kO
kO
kO
kO
kO
kO
kO
kO
kO
kO
kO
kO
kO
kO
Ps
Nj
Nj
Nj
Nj
Nj
Nj
Nj
Nj
Nj
Nj
Nj
Nj
Nj
Nj
Nj
FK
kO
kO
kO
kO
kO
kO
kO
kO
kO
kO
kO
"}
(34,1,1) = {"
kO
kO
kO
kO
kO
kO
kO
kO
kO
kO
kO
kO
kO
kO
Nj
Nj
kO
Ps
kO
kO
kO
kO
kO
kO
kO
kO
kO
kO
kO
kO
kO
kO
kO
kO
kO
kO
kO
kO
kO
kO
kO
kO
Ps
Nj
Nj
Nj
Nj
Nj
Nj
Nj
Nj
Nj
Nj
Nj
Nj
Nj
Nj
Nj
FK
kO
kO
kO
kO
kO
kO
kO
kO
kO
kO
kO
"}
(35,1,1) = {"
kO
kO
kO
kO
kO
kO
kO
kO
kO
kO
kO
kO
kO
kO
Nj
Nj
kO
Ps
kO
kO
kO
kO
kO
kO
kO
kO
kO
kO
kO
kO
kO
kO
kO
kO
kO
kO
kO
kO
kO
kO
kO
kO
Ps
vV
vV
vV
vV
vV
Nj
Nj
Nj
Nj
Nj
Nj
Nj
Nj
Nj
Nj
FK
kO
kO
kO
kO
kO
kO
kO
kO
kO
kO
kO
"}
