//MAP CONVERTED BY dmm2tgm.py THIS HEADER COMMENT PREVENTS RECONVERSION, DO NOT REMOVE
"a" = (
/turf/template_noop,
/area/space)
"p" = (
/obj/modular_map_root/safehouse{
	key = "ancient_milsim"
	},
/turf/template_noop,
/area/space)
"y" = (
/turf/closed/wall/mineral/titanium,
/area/space)
"F" = (
/turf/open/misc/grass/planet/ancient_milsim,
/area/space)
"N" = (
/turf/closed/indestructible/binary,
/area/space)
"T" = (
/turf/closed/indestructible/rock,
/area/space)
"V" = (
/turf/open/floor/iron,
/area/space)

(1,1,1) = {"
N
N
N
N
N
N
N
N
N
N
N
N
N
N
N
N
N
N
N
N
N
N
N
"}
(2,1,1) = {"
N
y
y
y
y
y
y
y
y
y
y
y
y
y
y
y
a
a
a
a
a
p
N
"}
(3,1,1) = {"
N
y
V
V
V
V
V
V
V
V
V
V
V
V
V
V
a
a
a
a
a
a
N
"}
(4,1,1) = {"
N
y
V
V
V
V
V
V
V
V
V
V
V
V
V
V
a
a
a
a
a
a
N
"}
(5,1,1) = {"
N
y
V
V
V
V
V
V
V
V
V
V
V
V
V
V
a
a
a
a
a
a
N
"}
(6,1,1) = {"
N
y
V
V
V
V
V
V
V
V
V
V
V
V
V
V
a
a
a
a
a
a
N
"}
(7,1,1) = {"
N
y
V
V
V
V
V
V
V
V
V
V
V
V
V
V
a
a
a
a
a
a
N
"}
(8,1,1) = {"
N
y
V
V
V
y
y
y
y
y
y
y
y
y
y
y
a
a
a
a
a
a
N
"}
(9,1,1) = {"
N
T
F
F
F
F
F
F
F
F
F
F
F
F
F
F
F
F
F
F
F
T
N
"}
(10,1,1) = {"
N
T
F
F
F
F
F
F
F
F
F
F
F
F
F
F
F
F
F
F
F
T
N
"}
(11,1,1) = {"
N
T
F
F
F
F
F
F
F
F
F
F
F
F
F
F
F
F
F
F
F
T
N
"}
(12,1,1) = {"
N
T
F
F
F
T
T
T
T
T
T
T
T
T
T
T
T
T
F
F
F
T
N
"}
(13,1,1) = {"
N
T
F
F
F
T
F
F
F
F
F
F
F
F
F
T
T
F
F
F
T
T
N
"}
(14,1,1) = {"
N
T
F
F
F
T
F
F
F
F
F
F
F
F
F
T
F
F
F
T
T
T
N
"}
(15,1,1) = {"
N
T
F
F
F
T
F
F
F
F
F
F
F
F
F
T
T
F
F
F
T
T
N
"}
(16,1,1) = {"
N
T
F
F
F
T
F
F
F
T
T
T
F
F
F
T
T
T
F
F
F
T
N
"}
(17,1,1) = {"
N
T
F
F
F
T
F
F
F
T
T
T
F
F
F
T
T
T
F
F
F
T
N
"}
(18,1,1) = {"
N
T
F
F
F
T
F
F
F
T
T
T
F
F
F
T
T
T
F
F
F
T
N
"}
(19,1,1) = {"
N
T
F
F
F
F
F
F
F
T
T
T
F
F
F
F
F
F
F
F
F
T
N
"}
(20,1,1) = {"
N
T
F
F
F
F
F
F
F
T
T
T
F
F
F
F
F
F
F
F
F
T
N
"}
(21,1,1) = {"
N
T
F
F
F
F
F
F
F
T
T
T
F
F
F
F
F
F
F
F
F
T
N
"}
(22,1,1) = {"
N
T
T
T
T
T
T
T
T
T
T
T
T
T
T
T
T
T
T
T
T
T
N
"}
(23,1,1) = {"
N
N
N
N
N
N
N
N
N
N
N
N
N
N
N
N
N
N
N
N
N
N
N
"}
